    Afghanistan	Kabul
	Ägypten	Kairo
	Akrotiri	Episkopi Cantonment
	Albanien	Tirana
	Algerien	Algier
	Amerikanische Jungferninseln	Charlotte Amalie
	Amerikanisch-Samoa	Pago Pago
	Andorra	Andorra la Vella
	Angola	Luanda
	Anguilla	The Valley
	Antigua und Barbuda	St. John's
	Äquatorialguinea	Malabo
	Argentinien	Buenos Aires
	Armenien	Eriwan
	Aruba	Oranjestad
	Aserbaidschan	Baku
	Äthiopien	Addis Abeba
	Australien	Canberra
	Bahamas	Nassau
	Bahrain	Manama
	Bangladesch	Dhaka
	Barbados	Bridgetown
	Belarus	Minsk
	Belgien	Brüssel
	Belize	Belmopan
	Benin	Porto Novo	Cotonou
	Bermuda	Hamilton
	Bhutan	Thimphu
	Bolivien	Sucre	La Paz
	Bonaire	Kralendijk
	Bosnien und Herzegowina	Sarajewo
	Botsuana	Gaborone
	Brasilien	Brasília
	Britische Jungferninseln	Road Town
	Brunei Darussalam	Bandar Seri Begawan
	Bulgarien	Sofia
	Burkina Faso	Ouagadougou
	Burundi	Bujumbura
	Cabo Verde	Praia
	Chile	Santiago de Chile	Valparaíso
	China	Peking (Beijing)
	Cookinseln	Avarua
	Costa Rica	San José
	Côte d'Ivoire	Yamoussoukro	Abidjan
	Curaçao	Willemstad
	Dänemark	Kopenhagen
	Deutschland	Berlin
	Dhekelia	Episkopi Cantonment
	Dominica	Roseau
	Dominikanische Republik	Santo Domingo
	Dschibuti	Dschibuti
	Ecuador	Quito
	El Salvador	San Salvador
	England	London
	Eritrea	Asmara
	Estland	Tallinn (Reval)
	Europäische Union	Brüssel
	Falklandinseln	Stanley
	Färöer	Tórshavn
	Fidschi	Suva
	Finnland	Helsinki
	Frankreich	Paris
	Französisch-Guayana	Cayenne
	Französisch-Polynesien	Papeete
	Gabun	Libreville
	Gambia	Banjul
	Gazastreifen	Gaza-Stadt (provisorisch)
	Georgien	Tiflis
	Ghana	Accra
	Gibraltar	Gibraltar
	Grenada	St. George´s
	Griechenland	Athen
	Grönland	Nuuk (Godthab)
	Großbritannien	London
	Guadeloupe	Basse-Terre
	Guam	Hagåtña (Agana)
	Guatemala	Guatemala-Stadt
	Guernsey	St. Peter Port
	Guinea	Conakry
	Guinea-Bissau	Bissau
	Guyana	Georgetown
	Haiti	Port-au-Prince
	Honduras	Tegucigalpa
	Hongkong	Sonderverwaltungszone der Volksrepublik China
	Indien	Neu-Delhi
	Indonesien	Jakarta
	Insel Man	Douglas
	Irak	Bagdad
	Iran	Teheran
	Irland	Dublin
	Island	Reykjavik
	Israel	Jerusalem (de jure)	Tel Aviv (de facto)
	Italien	Rom
	Jamaika	Kingston
	Japan	Tokio
	Jemen	Sanaa
	Jersey	Saint Helier
	Jordanien	Amman
	Kaimaninseln	George Town
	Kambodscha	Phnom Penh
	Kamerun	Jaunde (Yaoundé)
	Kanada	Ottawa
	Kasachstan	Astana
	Katar	Doha
	Kenia	Nairobi
	Kirgisistan	Bischkek
	Kiribati	Tarawa	Bairiki
	Kokosinseln (Keelinginseln)	West Island
	Kolumbien	Bogotá
	Komoren	Moroni
	Kongo	Brazzaville
	Kongo, Demokratische Republik	Kinshasa
	Korea, Demokratische Volksrepublik	Pjöngjang
	Korea, Republik	Seoul
	Kosovo	Priština
	Kroatien	Zagreb (Agram)
	Kuba	Havanna
	Kuwait	Kuwait-Stadt
	Laos	Vientiane
	Lesotho	Maseru
	Lettland	Riga
	Libanon	Beirut
	Liberia	Monrovia
	Libyen	Tripolis
	Liechtenstein	Vaduz
	Litauen	Wilna (Vilnius)
	Luxemburg	Luxemburg (Stadt)
	Macau	Sonderverwaltungszone der Volksrepublik China
	Madagaskar	Antananarivo
	Malawi	Lilongwe
	Malaysia	Kuala Lumpur	Putrajaya (Verwaltungszentrum)
	Malediven	Male
	Mali	Bamako
	Malta	Valletta
	Marokko	Rabat
	Marshallinseln	Uliga
	Martinique	Fort-de-France
	Mauretanien	Nouakchott
	Mauritius	Port Louis
	Mayotte	Mamoudzou
	Mazedonien	Skopje
	Mexiko	Mexiko-Stadt
	Mikronesien	Palikir
	Moldau	Kischinau
	Monaco	Monaco
	Mongolei	Ulan-Bator
	Montenegro	Podgorica
	Montserrat	Plymouth	Brades (de facto)
	Mosambik	Maputo
	Myanmar	Naypyidaw
	Namibia	Windhuk
	Nauru	keine offizielle Hauptstadt, inoffiziell Yaren
	Nepal	Kathmandu
	Neukaledonien	Nouméa
	Neuseeland	Wellington
	Nicaragua	Managua
	Niederlande	Amsterdam	Den Haag
	Niederländische Antillen	Willemstad (auf Curaçao)
	Niger	Niamey
	Nigeria	Abuja
	Niue	Alofi
	Nördliche Marianen	Saipan
	Nordzypern	Nikosia
	Norfolkinsel	Kingston
	Norwegen	Oslo
	Oman	Maskat
	Österreich	Wien
	Pakistan	Islamabad
	Palau	Melekeok
	Panama	Panama-Stadt
	Papua-Neuguinea	Port Moresby
	Paraguay	Asunción
	Peru	Lima
	Philippinen	Manila
	Pitcairninseln	Adamstown
	Polen	Warschau
	Portugal	Lissabon
	Puerto Rico	San Juan
	Réunion	Saint-Denis
	Ruanda	Kigali
	Rumänien	Bukarest
	Russische Föderation	Moskau
	Saba	The Bottom
	Saint-Martin	Marigot
	Salomonen	Honiara
	Sambia	Lusaka
	Samoa	Apia
	San Marino	San Marino
	São Tomé und Príncipe	São Tomé
	Saudi-Arabien	Riad
	Schweden	Stockholm
	Schweiz	Bern (de facto)
	Senegal	Dakar
	Serbien	Belgrad
Serbien und Montenegro	Belgrad
	Seychellen	Victoria
	Sierra Leone	Freetown
	Simbabwe	Harare
	Singapur	Singapur
	Sint Eustatius	Oranjestad
	Sint Maarten	Philipsburg
	Slowakei	Bratislava (Pressburg)
	Slowenien	Ljubljana (Laibach)
	Somalia	Mogadischu
	Spanien	Madrid
	Spitzbergen	Longyearbyen
	Sri Lanka	Colombo	Sri Jayawardenepura (Parlamentssitz)
	St. Barthélemy	Gustavia
	St. Helena	Jamestown
	St. Kitts und Nevis	Basseterre
	St. Lucia	Castries
	St. Pierre und Miquelon	Saint-Pierre
	St. Vincent und die Grenadinen	Kingstown
	Südafrika	Pretoria	Kapstadt (Parlamentssitz)
	Sudan	Khartum
	Südsudan	Dschuba
	Suriname	Paramaribo
	Swasiland	Mbabane
	Syrien	Damaskus
	Tadschikistan	Duschanbe
	Taiwan	Taipeh
	Tansania	Dodoma	Daressalam (Regierungssitz)
	Thailand	Bangkok
	Timor-Leste	Dili
	Togo	Lomé
	Tokelau	keine Hauptstadt, jedes Atoll hat sein eigenes Verwaltungszentrum	Fakaofo (Verwaltungssitz)
	Tonga	Nuku'alofa
	Trinidad und Tobago	Port-of-Spain
	Tschad	N'Djamena
	Tschechische Republik	Prag
	Tunesien	Tunis
	Türkei	Ankara
	Turkmenistan	Aschgabat
	Turks- und Caicosinseln	Cockburn Town
	Tuvalu	Funafuti	Vaiaku
	Uganda	Kampala
	Ukraine	Kiew
	Ungarn	Budapest
	Uruguay	Montevideo
	Usbekistan	Taschkent
	Vanuatu	Port Vila
	Vatikanstadt	Vatikanstadt
	Venezuela	Caracas
	Vereinigte Arabische Emirate	Abu Dhabi
	Vereinigte Staaten	Washington (D.C.)
	Vietnam	Hanoi
	Wallis und Futuna	Mata-Utu
	Weihnachtsinsel	Flying Fish Cove (The Settlement)
	Westjordanland	Ramallah
	Westsahara	El Aaiun (verfassungsgemäß)	Tindouf (Algerien)
	Zentralafrikanische Republik	Bangui
	Zypern	Nikosia